xxxxxxxxxxx
x_________x
x_________x
x______s__x
x_________x
x________fx
x_________x
x_________x
x_________x
x_________x
xxxxxxxxxxx
