xxxxxxxxxxxxxxxxxxxx
x_______x__x_x_____x
x_xxx_x_x__x_x_x_xxx
x_x___x_x__x_x_x___x
x_xxxxxxx____xx_xxxx
x_x__x__x__x_______x
x_x_____x__x_x_____x
x_x_xxxxxxxxxxx_sxxx
x_______x__________x
x_x__x__x__x_______x
xvx_xxxxxxx_xxxxxxxx
x_x_xv__x______x___x
x_x_x_xxx_x_x__x_x_x
x_x_xf____x_x__x_x_x
x___x_x_x_xxx_xx_x_x
xxx_xx_xx___x__x_x_x
x___x___x___x____x_x
x_xx__x_xxxxxxxxx_xx
x___x_x_x__________x
xxxxxxxxxxxxxxxxxxxx
